############################
|   }               {      |
| M }               {      |
|%%%%                %%%%%%|
|    !%!  +                |
|        !%%!              |
|          @      @        |
|       !%%%%!  !%%%!      |
|@                     @   |
|!%%%%!              !%%%%!|
|       @     @     @   \\\|
|      !%%%%%%!   !%%%! [ [|
|      @          @   @ [0[|
############################