############################
|&&&                       |
|&O&                       |
|%%%  +                    |
|    !%!   @               |
|        !%%!        !%%%%!|
|         @       @        |
|       !%%%%!  !%%%!      |
|                      @   |
|!%%%%!              !%%%%!|
|       @     @     @      |
|      !%%%%%%!   !%%%!    |
|      @                 @ |
############################