########################################################################################################
||       !                                                                                            ||
||       !                                                                                            ||
||   -   !                                                                                            ||
||       !                                                                                            ||
|||%%%%%%|                                                                                            ||
||                                                                                                    ||
||                                                                                                    ||
||                                                                                                    ||
||            @                                                                                       ||
||        |%%%%%%|  @                                                                                 ||
||               |%%%%|  @                                                                            ||
||                    |%%%%|      @                     @ @ @                        %#%#%#%#%#%#%#%#%||
||                         |%%%%%%%%%%%%%|          |%%%%%%%%%%%%%|                  $                ||
||                                                                                   $                ||
||                                                                                   $                ||
||                                                                                   $                ||
||                                    @       @       @                              $                ||
||                                   |%%%%%%%%%%%%%%%%%|                             $                ||
||                                                                                   $                ||
||                                                                                   $                ||
||                                                                                   $                ||
||                        @ @ @                                                      $                ||
||                  |%%%%%%%%%%%%%%%|                                                $                ||
||                                                                                   $                ||
||                                                                                   $                ||
||                                                                                   $                ||
||                                   @          @                                    $                ||
||                                  |%%%%%%%%%%%%|                                   %#%#%#%#%#%#%#%#%||
||                                                                                                    ||
||                                                                                                    ||
||                                                                                                    ||
||                                                                                                    ||
||                            |%%%%%%%%%%%%%%%%%%%%%%%%%%%%%%%%%%%%%%%%%%%%%%%%%%%%%%%%%%%%%%%%%%%%%%|||
||                                                                                                    ||
||                                                                                                    ||
||                                                                                   @ @ @            ||
||                    @ @ @ @ @ @                                                                     ||
||          |%%%%%%%%%%%%%%%%%%%%%%%%%%%%%%%%%%%%%%%%%%%%%%%%%%%%%|                                   ||
||                                                                                                    ||
||                                                                                                    ||
||                                                                                                    ||
||                      @ @                                         @ @ @              @ @ @          ||
########################################################################################################
